1, Piso1_a, 1
2, Piso1_b, 0
3, Pared1_b, 0
4, Nada, 0
5, Nada2, 1
6, Pared3_e, 0
4|5|3|3|3|3|3|3|3|3|3|3|3|4
4|1|1|1|1|1|1|1|1|1|1|1|1|4
4|1|1|1|1|1|1|1|1|1|1|1|1|4
4|4|4|4|4|4|4|4|4|4|1|1|1|4
4|3|3|3|3|3|3|3|3|3|1|1|1|4
4|1|1|1|1|1|1|1|1|1|1|1|1|4
4|1|1|1|1|1|1|1|1|1|1|1|1|4
4|1|1|4|4|4|4|4|4|4|4|4|4|4
4|5|5|4|4|4|4|4|4|4|4|4|4|4
