1, Piso1_a, 1
2, Piso1_b, 0
3, Pared1_b, 0
4, Nada, 0
1|3|4|4|4|4|4|4|4|4|4|4
1|1|4|4|4|4|4|4|4|4|4|4
1|1|3|3|3|3|3|3|3|3|1|3
1|1|1|1|1|1|1|1|1|1|1|1
1|1|1|1|1|1|1|1|1|1|1|1
4|4|4|4|4|4|4|4|4|4|4|4
4|4|4|4|4|4|4|4|4|4|4|4
