1, Madera4, 1
2, Baldosa5, 0
3, Alfombra1_a, 1
4, Alfombra1_b, 1
5, Alfombra1_c, 1
6, Alfombra1_d, 1
7, Alfombra1_e, 1
8, Alfombra1_f, 1
3|4|4|4|4|4|4|4|4|4|4|4|4|4|4|4|4|4|4|4|4|5
6|7|7|7|7|7|7|7|7|7|7|7|7|7|7|7|7|7|7|7|7|8
1|1|1|1|2|2|2|2|1|1|1|1|1|1|2|2|2|1|1|1|1|1
1|1|1|1|1|1|1|2|2|2|1|1|1|1|1|1|1|1|1|1|1|1
1|1|1|1|2|2|2|1|1|1|1|1|1|1|2|2|2|1|1|2|1|1
2|2|1|1|1|1|1|2|2|2|2|2|2|2|2|1|1|1|1|1|1|1
1|1|1|1|2|1|1|1|1|1|1|1|1|1|1|2|2|2|1|1|1|1
1|1|2|2|2|2|1|1|2|2|2|2|1|1|1|1|2|2|2|1|1|1
1|1|1|1|1|1|1|1|1|1|1|1|1|1|1|1|1|1|1|1|1|1
1|1|1|1|1|1|1|1|1|1|1|1|1|1|1|1|1|1|1|1|1|1
1|1|1|1|1|1|1|1|1|1|1|1|1|1|1|1|1|1|1|1|1|1
1|1|1|1|1|1|2|2|2|2|2|2|2|2|1|1|1|1|1|1|1|1
2|1|1|2|2|2|2|2|2|2|2|2|2|2|2|2|2|1|1|2|2|2
1|1|1|3|4|4|4|4|4|4|4|4|4|4|4|4|5|1|1|1|1|1
1|1|1|6|7|7|7|7|7|7|7|7|7|7|7|7|8|1|1|1|1|1
2|2|2|2|2|2|2|2|2|2|2|2|2|2|2|2|2|2|2|2|2|2
